0,10,3,1 2 3,-1,0,1
0,10,3,4 5 6,-1,0,1
0,13,4,2 5 2 6,-1,0,1
0,13,6,2 7 2 8 2 9,-1,0,1
5,15,2,9 6 9,-1,0,1
5,15,3,6 10 14,-1,0,1
5,18,4,18 8 6 11,-1,0,1
5,18,4,8 11 14 17,-1,0,1
5,18,3,13 15 17,-1,0,1
10,20,3,11 16 20,3,-80,1
10,20,2,,3,-80,1
15,25,3,21 23 25,3,-80,1
15,28,3,21 23 27,3,-80,1
30,43,2,,3,-100,1
35,48,2,,3,-100,1
45,55,3,,2,-100,0
60,70,4,,2,-110,0
80,93,2,,2,-110,0
87,100,3,,2,-110,0
